/TTTTTTTTTTTTTTTTTTTTTTTTTTTTTTTTTTTTTTTTTTTTTT\
L----------------------------------------------R
L----------------------------------------------R
L-------------------------------------/TTT23TTT\
L-------------------------------------lFFF45FFFr
L-------------------------------------L--------R
L-------------------------------------L--------R
L-------------------------------------L--------R
L-------------------------------------6BBBBBBBB9
L-------------------------------------FFFFFFFFFF
L----------------------------------------------R
L----------------------------------------------R
L----------------------------------------------R
L----------------------------------------------R
L----------------------------------------------R
L----------------------------------------------R
L----------------------------------------------R
L----------------------------------------------R
L----------------------------------------------R
L----------------------------------------------R
L----------------------------------------------R
L----------------------------------------------R
L----------------------------------------------R
L----------------------------------------------R
L----------------------------------------------R
6BBBBBBBBBBBBBBBBBBBBB23BBBBBBBBBBBBBBBBBBBBBBB9
FFFFFFFFFFFFFFFFFFFFFF45FFFFFFFFFFFFFFFFFFFFFFFF
STOP